1111111111111
1001000000001
1000011111011
1P0011E0001C1
1111111111111