1111111111111
1001000000001
1100011111001
1P1011E0000C1
1111111111111